WWWWWWWWWWWWWWWWWWWWWWWWWWWWWWWWWWWWWWWW
WTTTTTTTTTTTTTTTTTTTTTTTTTTTTTTTTTTTTTTW
WTSSSSSTTTTTTTTTTTTTOOOOOTTTTTTTTTpTTTTW
WTTTTTTTTTTTTpppTTTTTTpppTTTTTgTTTTTTTTW
WTTTTTTTTTTTTTTTTTTTTTp1pTTTTTTTTTTAAAAW
WTTTTTTTSSSSSTTTgTTTTTT2pTTTTTTTTTpTTTgW
WTTTTTTTTTTTTTTTTTTTTTpppTTTTTTTTTTTTTTW
WTTTTTTTTTTpTTTTTTTTTTTTTTTTpTTTTTTTTTTW
WTTTTTTTTTSSSSSTTTTpppTTTTTTTTTTgTTTTgTW
WTTTTTTTTTTTTTTTTTTTTTTTTTTTTTTTTTTTTTTW
WTTTSSSSSSSSSSTTTTTTTTSSTTTTTTTTTTTggTTW
WTpppppTTTTTTTTTTTTTOOOOOTTTTTTTTpTTTTTW
WTTTTTTTTTTpTpppTTTTTTpppTTTTgTTTTTTTTTW
WTTTT-TTTTTTTTTTTTTTTTpTpTTTTTTTTTAAAAAW
WTTTTTTTSSSSSTTTgTTTTTTpTpTTTTTTTTpTTTTW
WTTTTCTTTTTTTTTTTTTTTTpppTTTTTTTTTTTTTTW
WTTTTTTTTpppTTTTTTTTTTTTTTTTTTTTTpTTTTTW
WTTTTTTTTTSSSSSTTTTpppTTTTTTTTTgTTTTTTTW
WTTTTCTTTSSTTTTTTTTTTTTTTTTTTTTTTTTTTTTW
WTTTTTTTTTTTTTTTTTTTTTSSSSSppTTTTTTTTTTW
WWWWWWWWWWWWWWWWWWWWWWWWWWWWWWWWWWWWWWWW
