WWWWWWWWWWWWWWWWWWWWWWWWWWWWWWWWWWWWWWWWW
WTTTTTTTTTTTWWWWWWWWWWWWWTTTTTTTTTTTTTTWg
WTSSSSSTTTTTTOOOOOTTOOOOOTTTTTTTTWWWWWWWW
WTTTTTTTTTTTTTTTTTTTTTpppTTTTTTTTTTWWWWWg
WTTTggggggggggggggggggggWWWWWWWWWWWWWWWWW
WTTTCTTTSSSSSTTTgTTTTTTWpTTTTTTTTTTTTTgWg
WTTTWWWWWWSSTCCCCCTTTTpppTTTTCCCCTTTTWWWW
WTTTWWWWggggggTTTTTTTTTTTTTTpTTTTTTTWWWWg
WTTTTTTTTTSSSSSTTTTpppTTTTTTTTTTgTTTTgTWW
WTTTTTSSSSSSSSSSSSSSSSSSSSSSSTTTTTTTTTTWg
WTTTSSSSSSSSSSTTTTTTTTSSTTTTTTTTTTTggTTWW
WTOOOOOTTTTTTTCTTTTTOOOOOTTTTTTTTTTTTTTWg
WTOOOOTTTTTTTpppTTTTTTpppTTTTgTTTTTTTTTWW
WTTTWWWWWWWWWWTTTTTTTTpppTTTTTTTTTAAAAAWg
WTTTTTTTSSSSSTTTgTTTTTTpppTTTTTTTTTTTTTWW
WTppppppTTTTTTTTTTTTTTpppTTTTTTTTTTTTTTWg
WpppppppppppTTTTTTTTTTTTTTCTTTTCTTTTTTTWW
WTTTTTTTTTSSSSSTTTTpppTTTTTTTTTgTTTTTTTWg
WTTTT1TTTSSTTggTTTTTTTWWWWWWTTTTTTTTTTTWW
WTTTT2TTTTTTTTTTTCTTTTSSSSSppTTTTTTTTTTWg
WWWWWWWWWWWWWWWWWWWWWWWWWWWWWWWWWWWWWWWWW
