WWWWWWWWWWWWWWWWWWWWWWWWWWWWWWWWWWWWWWWWW
WTTTTTTTTTTTTTTTTTTTTTTTTTTTTTTTTTTTTTTWg
WTSSSSSTTTTTTTTTTTTTOOOOOTTTTTTTTTTTTTTgW
WTTTTTTTTTTTTpppTTTTTTpppTTTTTgTTTTTTTTgg
WTTTggggggggggggggggggggWWWWWWWWWWWWWWWWW
WTTTCTTTSSSSSTTTgTTTTTTWpTTTTTTTTTTTTTgWg
WTTTTTSSSSSSTTTTTTTTTTpppTTTTTTTTTTTTTTgW
WTTTTTTTTTTTTTTTTTTTTTTTTTTTpTTTTTTTTTTgg
WTTTTTTTTTSSSSSTTTTpppTTTTTTTTTTgTTTTgTWW
WTTTTTTTTTTTTTTTTTTTTTTTTTTTTTTTTTTTTTTWg
WTTTSSSSSSSSSSTTTTTTTTSSTTTTTTTTTTTggTTWW
WTpppppTTTTTTTTTTTTTOOOOOTTTTTTTTTTTTTTWg
WTTTTTTTTTTTTppp-TTTTTpppTTTTgTTTTTTTTTWW
WTTTTTTTTTTTTTTTTTTTTTpppTTTTTTTTTAAAAAWg
WTTTTTTTSSSSSTTTgTTTTTTpppTTTTTTTTTTTTTWW
WTTTTTTTTTTTTTTTTTTTTTpppTTTTTTTTTTTTTTWg
WpppppppppppTTTTCTTTTTTTTTTTTTTTTTTTTTTWW
WTTTTTTTTTSSSSSTTTTpppTTTTTTTTTgTTTTTTTWg
WTTTTTTTTSSTTggTTTTTTTTTTTTTTTTTTTTTTTTWW
WTTTTTTTTTTTTTTTTTTTTTSSSSSppTTTTTTTTTTWg
WWWWWWWWWWWWWWWWWWWWWWWWWWWWWWWWWWWWWWWWW
