WWWWWWWWWWWWWWWWWWWWWWWWWWWWWWWWWWWWWWWWW
WTTTTTTTTTTTTTTTTTTTTTTTTTTTTTTTTTTTTTTWg
WTSSSSSTTTTTTOOOOOTTOOOOOTTTTTTTTTTTTTTgW
WTTTTTTTTTTTTTTTTTTTTTpppTTTTTTTTTTTTTTgg
WTTTggggggggggggggggggggWWWWWWWWWWWWWWWWW
WTTTCTTTSSSSSTTTgTTTTTTWpTTTTTTTTTTTTTgWg
WTTTTTSSSSSSTTTTTTTTTTpppTTTTTTTTTTTTTTgW
WTTTTTTTTTTTTTTTTTTTTTTTTTTTpTTTTTTTTTTgg
WTTTTTTTTTSSSSSTTTTpppTTTTTTTTTTgTTTTgTWW
WTTTTTSSSSSSSSSSSSSSSSSSSSSSSTTTTTTTTTTWg
WTTTSSSSSSSSSSTTTTTTTTSSTTTTTTTTTTTggTTWW
WTOOOOOTTTTTTTCTTTTTOOOOOTTTTTTTTTTTTTTWg
WTOOOOTTTTTTTpppTTTTTTpppTTTTgTTTTTTTTTWW
WTTTTTTTTTTTTTTTTTTTTTp1pTTTTTTTTTAAAAAWg
WTTTTTTTSSSSSTTTgTTTTTTp2pTTTTTTTTTTTTTWW
WTppppppTTTTTTTTTTTTTTpppTTTTTTTTTTTTTTWg
WpppppppppppTTTTTTTTTTTTTTCTTTTCTTTTTTTWW
WTTTTTTTTTSSSSSTTTTpppTTTTTTTTTgTTTTTTTWg
WTTTTTTTTSSTTggTTTTTTTTTTTTTTTTTTTTTTTTWW
WTTTTTTTTTTTTTTTTCTTTTSSSSSppTTTTTTTTTTWg
WWWWWWWWWWWWWWWWWWWWWWWWWWWWWWWWWWWWWWWWW
