WWWWWWWWWWWWWWWWWWWWWWWWWWWWWWWWWWWWWWWWW
WTTTTTTTTTTTTTTTTTTTTTTTTTTTTTTTTTTTTTTWg
WTSSSSSTTTTTTOOOOOTTOOOOOTTTTTTTTTTTTTTgW
WTTTTTTTTTTTTTTTTTTTTTpppTTTTTTTTTWWWWWWg
WTTTggggggggggggggggggggWWWWWWWWWWWWWWWWW
WTTTTTTTSSSSSTTTgTTTTTTWpTTTTTTTTTTTTTgWg
WTTTTTSSSSSSTTTTTTTTTTpppTTTTTTTTTTTTTTgW
WTTTTTTTTTTTTTTTTTTTTTTTTTTTpTTTTTTTTTTgg
WTTTCCTTTTSSSSSTTTTpppTTTTTTTTTTgTTTTgTWW
WTTTTTSSSSSSSSSSSSSSSSSSSSSSSTTTTTTTTTTWg
WTTTSSSSSSSSSSTTTTTTTTSSTTTTTTTTTTTggTTWW
WTOOOOOTTTTTTTCTTTTTOOOOOTTTTTTTTTTTTTTWg
WTOOOOTTTTTTTpppTTTTTTpppTTTTgTTTTTTTTTWW
WTTTTTTTTTTTTTTTTTTTTTp1pTTTTTTTTTAAAAAWg
WTTTTTTTSSSSSTTTgTTTTTT2ppTTTTTTTTTTTTTWW
WTppppppTTTTTTTTTTTTTTpppTTTTTTTTTTTTTTWg
WpppppppppppTTTTTTTTTTTTTTCTTTTCTTTTTTTWW
WTTTTTTTTTSSSSSTTTTpppTTTTTTTTTgTTTTTTTWg
WTTTTTTTTSSTTggTTTTTTTTTTTTTTTTTTTTTTTTWW
WTTTTTTTTTTTTTTTTCTTTTSSSSSppTTTTTTTTTTWg
WWWWWWWWWWWWWWWWWWWWWWWWWWWWWWWWWWWWWWWWW
