WWWWWWWWWWWWWWWWWWWWWWWWWWWWWWWWWWWWWWWWW
WTTTTTTTTTTTTTTTTTTTTTTTTTTTTTTTTTTTTTTWg
WTSSSSSTTTTTTOOOOOTTOOOOOTTTTTTTTTTTTTTgW
WTTTgggggggggTTTTTTTTTpppTTTTTTTTTTTTTTgg
WTTTggggggggggggggggggggWWWWWWWWWWWWWWWWW
WTTTCTTTSSSSSTTTgTTTTTTWpTTTTTTTTTTTTTgWg
WTTTTTSSSSSSTTTTTTTTTTpppTTTTTTTTTTTTTTgW
WTTTTTTTTTTTTTTTTTTTTTTTTTTTpTTTTTTTTTTgg
WTTTTTTTTTSSSSSTTTTpppTTTTTTTTTTgTTTTgTWW
WTTTTTSSSSSSSSSSSSSSSSSSSSSSSTTTTTTTTTTWg
WTTTSSSSSSSSSSTTTTTTTTSSTTTTTTTTTTTggTTWW
WTOOOOOTTTTTTTCTTTTTOOOOOTTTTTTTTTTTTTTWg
WTOOOOTTTTTTTpppTTTTTTpppTTTTgTTTTTTTTTWW
WTTTWWWWWWWWWWWWWWWTTTpppTTTTTTTTTAAAAAWg
WTTTTTTTSSSSSTTTgTTTTTTpppTTTTTTTTTTTTTWW
WTppppppTTWWWWWWWTTTTTpppTTTTTTTTTTTTTTWg
WpppppppppppTTTTTTTTTTTTTTCTTTTCTTTTTTTWW
WTTTOOOOOOOSSSSTTTTpppTTTTTTTTTgTTTTTTTWg
WTTTTTTTTSSTTggTTTTTTTTTTTTTTTTTTTTTTTTWW
WTTTTTTTTTTTTTTTTCTTTTSSSSSppTTTTTTTTTTWg
WWWWWWWWWWWWWWWWWWWWWWWWWWWWWWWWWWWWWWWWW
