WWWWWWWWWWWWWWWWWWWWWWWWWWWWWWWWWWWWWWWWW
WTTTTTTTTTTTTTTTTTTTTTTTTTTTTTTTTTTTTTTWg
WTSSSSSTTTTTTOOOOOTTOOOOOTTTTTTTTTTTWWWWW
WTTTTTTTTTTTTTTTTTTTTTpppTTTTTTTTTTTWWWWg
WTTTggggggggggggggggggggWWWWWWWWWWWWWWWWW
WTTTCTTTSSSSSTTTgTTTTTTWpTTTTTTTTTTTTTgWg
WTTTTTSSSSSSTTTTTTTTTTpppTTTTTTTTTTTTTTWW
WTTTTTggggggggTTTTTTTTTTTTTTpTTTTTTTTTTWg
WTTTTTTTTTSSSSSTTTTpppTTTTTTTTTTgTTTTgTWW
WTTTTTSSSSSSSSSSSSSSSSSSSSSSSTTTTTTTTTTWg
WTTTSSSSSSSSSSTTTTTTTTSSTTTTTTTTTTTggTTWW
WTOOOOOTTTTTTTCTTTTTOOOOOTTTTTTTTTTTTTTWg
WTOOOOTTTTTTTpppTTTTTTpppTTTTgTTTTTTTTTWW
WTTTTTTTTTTTTTTTTTTTTTpppTTTTTTTTTAAAAAWg
WTTTTTTTSSSSSTTTgTTTTTTpppTTTTTTTTTTTTTWW
WTppppppTTTTTTTTTTTTTTpppTTTTTTTTTTTTTTWg
WpppppppppppTTTTTTTTTTTTTTCTTTTCTTTTTTTWW
WTTTTTTTTTSSSSSTTTTpppTTTTTTTTTgTTTTTTTWg
WTTTTTTTTSSTTggTTTTTTTTTTTTTTTTTTTTTTTTWW
WTTTTTTTTTTTTTTTTCTTTTSSSSSppTTTTTTTTTTWg
WWWWWWWWWWWWWWWWWWWWWWWWWWWWWWWWWWWWWWWWW
